Level 2
Вспомним математику (берите выше): 2+2*2+2
18 10
BBBBBBBXBBBBBBBBBB
BXXXXXXXXXXXXXXXXB
BXXXXXXXXXXXXXXXXB
BXXXXXXXXXXXXXXXXB
BXXXXXXXXXXXXXXXXB
BXXXXXXXXXXXXXXXXB
BXXXXXXXXXXXXXXXXB
XXXXXXXXXXXXXXXXXX
XXXXXXXXXXXXXXXXXD
BBBBXXXXXXXXXXBBBB