Level 3
Кажется, нужна пауза...
18 10
BBBBBBBBBBBBBBBBBB
BXXXXXXXXXXXXXXXXB
BXXXXXXXXXXXXXXXXB
BBBXXXXXXXXXXXXBBB
BXXXBXXXXXXXXBXXXB
BXXXXXXXXXXXXXXXXB
BXXXXXXXBBXXXXXXXB
XXXXXXXXXXXXXXXXXX
XXXXXXXXXXXXXXXXXD
BBBBBBBBBBBBBBBBBB