Level 1
Здесь всё просто.
18 10
BBBBBBBBBBBBBBBBBB
BXXXXXXXXXXXXXXXXB
BXXXXXXXXXXXXXXXXB
BXXXXXXXXXXXXXXXXB
BXXXXXXXXXXXXXXXXB
BXXXXXXXXXXXXXXXXB
BXXXXXXXXXXXXXXXXB
XXXXXXXXXXXXXXXXXX
XXXXXXXXXXXXXXXXXD
BBBBBBBBBBBBBBBBBB